Author: Thinking Rabbit, Level 14
       #######
 #######     #
 #     # $@$ #
 #$$ #   #########
 # ###......##   #
 #   $......## # #
 # ###......     #
##   #### ### #$##
#  #$   #  $  # #
#  $ $$$  # $## #
#   $ $ ###$$ # #
#####     $   # #
    ### ###   # #
      #     #   #
      ########  #
             #### 
