Author: Thinking Rabbit, Level 25
####
#  ##############
#  #   ..#......#
#  # # ##### ...#
##$#    ........#
#   ##$######  ####
# $ #     ######@ #
##$ # $   ######  #
#  $ #$$$##       #
#      #    #$#$###
# #### #$$$$$    #
# #    $     #   #
# #   ##        ###
# ######$###### $ #
#        #    #   #
##########    ##### 
