Author: Thinking Rabbit, Level 32
      ####
  #####  #
 ##     $#
## $  ## ###
#@$ $ # $  #
#### ##   $#
 #....#$ $ #
 #....#   $#
 #....  $$ ##
 #... # $   #
 ######$ $  #
      #   ###
      #$ ###
      #  #
      #### 
