Author: Thinking Rabbit, Level 40
    ############
    #          ##
    #  # #$$ $  #
    #$ #$#  ## @#
   ## ## # $ # ##
   #   $ #$  # #
   #   # $   # #
   ## $ $   ## #
   #  #  ##  $ #
   #    ## $$# #
######$$   #   #
#....#  ########
#.#... ##
#....   #
#....   #
######### 
