Author: Thinking Rabbit, Level 44
 #####
 #   #
 # # #######
 #      $@######
 # $ ##$ ###   #
 # #### $    $ #
 # ##### #  #$ ####
##  #### ##$      #
#  $#  $  # ## ## #
#         # #...# #
######  ###  ...  #
     #### # #...# #
          # ### # #
          #       #
          ######### 
