Author: Thinking Rabbit, Level 50
      ############
     ##..    #   #
    ##..* $    $ #
   ##..*.# # # $##
   #..*.# # # $  #
####...#  #    # #
#  ## #          #
# @$ $ ###  #   ##
# $   $   # #   #
###$$   # # # # #
  #   $   # # #####
  # $# #####      #
  #$   #   #    # #
  #  ###   ##     #
  #  #      #    ##
  ####      ###### 
